***************
*             *
*             *
*             *
*           ! *
*             *
*             *
*       #     *
*    !  !!! #^*
*       !     *
*       !     *
*             *
*       !     *
*             *
***************