**********        
**********        
**^     **        
**      **        
**      **  ******
**    ##**  ******
**    # **  ** !**
**      **  **  **
******  ****** !**
******  ******  **
  ****         !**`
  ****          **
  **      **    **
  **      **    **
  **      ********
  **      ********
  **********      
  **********      
