******************
**  ^    *********
**   ##  *********
**  ##   *********
**       *********
*******    *******
*******    *******
*******    *******
*******    *******
*******    *******
*******    *******
*******    *******
*******    *! ! **
*******    * ! !**
*******         **
*******         **
******************
******************
