******************
* ^ **************
* # **************
*   **************
*  ***************
*  ******   !  ***
*  ******      ***
*  ****** !  ! ***
*  ********* *****
*  ********* *****
*  ********* *****
*  ********* *****
*  ********* *****
*  ********* *****
*            # ***
* # *******    ***
*   **************
******************
