******************
*       ^        *
* #************# *
*  *          *  *
*  *          *  *
*  *  **  **  *  *
*  *  *    *  *  *
*  *  *    *  *  *
*  *  *    *  *  *
*  *  *! ! *  *  *
*  *  * ! !*  *  *
*  *  ******  *  *
*  *          *  *
*  *   #  #   *  *
*  ***     ****  *
*                *
*                *
******************