*********        
* ^              
*       *        
*       *        
* #     *        
*       *        
*** * ***********
   #  ***********
 * #  ***********
 **** ******  ***
  **            *
  *      **     *
         ** *   *
  *      ** !   *
   *   * !*******
   *     !*******
    *** * ****   
    ***   ****    