 ******************
 *!#           ^ !*
 * ************#*#*
 * *            * *
 * *            * *
 * *            !!*
 * *           #* *
 * *            * *
 * *           #* *
 * *            * *
 * *            * *
 * *            * *
 * *            *!*
 * *            *#*
 *              *!*
 *#** *********#* *
  !            !  *
 ****************** 